अइया	əɪjaː
एकजुटता	eːkədʒʊʈəʈaː
ग्रान्ट	ɡɾaːnʈ
जागने	dʒaːɡəneː
तालाबों	ʈaːlaːbõ
निहायत	nɪɦaːjət
पकता	pəkəʈaː
पब्लिक	pəblɪk
परिसीमन	pəɾɪsiːmən
पाताल	paːʈaːl
पीएचईडी	piːeːtʃəiːɖiː
पौने	pɔːneː
प्राइस	pɾaːɪs
फर्नीचर	pʰərniːtʃəɾ
फ़र्नीचर	fərniːtʃəɾ
फ़ूड	fuːɖ
फूफा	pʰuːpʰaː
फूफाजी	pʰuːpʰaːdʒiː
फूर्ती	pʰuːɾʈiː
फ्रिज	pʰɾɪdʒ
फ्रिसबी	pʰɾɪsəbiː
फ्रिसबीका	pʰɾɪsəbiːkaː
फ्री	pʰɾiː
फ्रीकशो	pʰɾiːkəʃoː
फ्रीकशोकहाँ	pʰɾiːkəʃoːkəɦã
फ्रीकशोने	pʰɾiːkəʃoːneː
फ्रीका	pʰɾiːkaː
बदलने	bədələneː
बदला	bədəlaː
बलिहारी	bəlɪɦaːɾiː
बलूचिस्तान	bəluːtʃɪsʈaːn
बलेथा	bəleːtʰaː
बलेनो	bəleːnoː
बलैया	bəlɛːjaː
बलोन्मत्त	bəloːnmətt
बलों	bəlõ
बिखरा	bɪkʰəɾaː
बिखराब	bɪkʰəraːb
बेगानापन	beːɡaːnaːpən
पाथती	paːtʰəʈiː
मिस्टेकन	mɪsʈeːkən
जयराम	dʒəjəɾaːm
थरुहट	tʰəɾʊɦəʈ
तां	ʈã
जलार्पण	dʒəlaːɾpəɳ
करावेंगे	kəɾaːʋẽːɡeː
चलोमुन्नी	tʃəloːmʊnniː
आर्द्र	aːɾdər
ठहरे	ʈʰəɦəɾeː
पहुंचाई	pəɦũtʃaːiː
सिकोडकर	sɪkoːɖəkəɾ
अच्तुराल्ली	ətʃːʈʊɾaːlliː
सराहा	səɾaːɦaː
कागजों	kaːɡədʒõ
जरूरत	dʒəɾuːɾət
बेकरार	beːkəraːɾ
बवार्ची	bəʋaːɾtʃiː
मैथिली	mɛːtʰɪliː
क्रूज	kəruːdʒ
मामा	maːmaː
होरी	ɦoːɾiː
रूखी	ɾuːkʰiː
तमासा	təmaːsaː
शोहदापन	ʃoːɦədaːpən
कलैय्ल	kəlɛːjl
झिटकार	dʒʰɪʈəkaːɾ
चंदे	tʃə̃deː
सरगर्मियां	səɾəɡərmɪjã
आरएएफ	aːɾəeːeːpʰ
यूपी	juːpiː
आयरलैंड	aːjəɾəlɛ̃ɖ
जीआरपी	dʒiːaːɾəpiː
भूखंड	bʰuːkʰə̃ɖ
प्रिंसेस	pɾiː̃seːs
अग्रेज	əɡɾeːdʒ
परचे	pəɾətʃeː
डी.आई.जी.	ɖiː aːiː dʒiː
संगदिल	sə̃ɡədɪl
खोपड़ी	kʰoːpəɽiː
पीछेवाला	piːtʃʰeːʋaːlaː
सीक्रेट	siːkəreːʈ
बडाबल	bəɖaːbəl
हमारी	ɦəmaːɾiː
खिलाकर	kʰɪlaːkəɾ
लक्मे	ləkmeː
बैठकबाज	bɛːʈʰəkəbaːdʒ
कुड़वार	kʊɽəʋaːɾ
कलेक्शन	kəleːkʃən
नूरु	nuːɾʊ
कांबोज	kãboːdʒ
सहारनपुर	səɦaːɾənəpʊɾ
ष्पााणाचित्रों	ʂpaːaːɳaːtʃɪʈɾõ
ब्याह	bjaːɦ
मुगलई	mʊɡələiː
जैसाकंगन	dʒɛːsaːkə̃ɡən
किसने	kɪsəneː
रहेगानहीं	ɾəɦeːɡaːnəɦiː̃
छत्री	tʃʰəʈɾiː
खलील	kʰəliːl
मूर्तिवादियों	muːɾʈɪʋaːdɪjõ
थालियों	tʰaːlɪjõ
भांजी	bʰãdʒiː
अत्याधुनिक	ətːjaːdʰʊnɪk
मरते	məɾəʈeː
संहार	sə̃ɦaːɾ
धमदाहा	dʰəmədaːɦaː
बासे	baːseː
राष्ट्रवाद	ɾaːʂʈɾəʋaːd
साये	saːjeː
पकौडियां	pəkɔːɖɪjã
कसका	kəsəkaː
बिगाड़ता	bɪɡaːɽəʈaː
हालाकि	ɦaːlaːkɪ
मंडोवी	mə̃ɖoːʋiː
अवाम	əʋaːm
रिंग	ɾiː̃ɡ
लोनिवि	loːnɪʋɪ
खोना	kʰoːnaː
दाँती	dãʈiː
रेमिटेंस	ɾeːmɪʈẽːs
रेगुलेटरी	ɾeːɡʊleːʈəɾiː
चनाचुर	tʃənaːtʃʊɾ
बडे़	bəɖeː
रिश्तेदारों	ɾɪʃʈeːdaːɾõ
कांवेंट	kãʋẽːʈ
थूथन	tʰuːtʰən
एनएचएआइ	eːnəeːtʃəeːaːɪ
नानाद	naːnaːd
पढ़िए	pəɽɦɪeː
अपलोडिंग	əpəloːɖiː̃ɡ
बच्ची	bətʃtʃiː
खोलानिस	kʰoːlaːnɪs
हाउती	ɦaːʊʈiː
होजालपा	ɦoːdʒaːləpaː
खींचा	kʰiː̃tʃaː
तिरुपूर	ʈɪɾʊpuːɾ
नियुक्त	nɪjʊkt
ते	ʈeː
शुभेच्छाएं	ʃʊbʰeːtʃːtʃʰaːẽː
बेसुध	beːsʊdʰ
वॉरइस	ʋoːɾəɪs
गोलच्यू	ɡoːlətʃːjuː
फ़ैसले	fɛːsəleː
साथीमत	saːtʰiːmət
बीसा	biːsaː
अफ़रा	əfəɾaː
एलोपेशिया	eːloːpeːʃɪjaː
सांझे	sãdʒʰeː
बतावेगी	bəʈaːʋeːɡiː
मांगते	mãɡəʈeː
हानेडा	ɦaːneːɖaː
नेक्स	neːks
चंद्रिका	tʃə̃dəɾɪkaː
हूति	ɦuːʈɪ
बूँदा	bũdaː
स्लम	sləm
लपकतीं	ləpəkəʈiː̃
अंधेरी	ə̃dʰeːɾiː
माफ़ी	maːfiː
राजेंद्र	ɾaːdʒẽːdər
मनोचिकित्सक	mənoːtʃɪkɪʈsək
टीआरपी	ʈiːaːɾəpiː
मन्त्रालय	mənʈɾaːləɛj
ठनका	ʈʰənəkaː
गाढ़े	ɡaːɽɦeː
स्पॉलइर	spoːləɪɾ
अररिया	əɾəɾɪjaː
क्रोधावेश	kəroːdʰaːʋeːʃ
प्रमदा	pɾəmədaː
छूटके	tʃʰuːʈəkeː
आक्सीजन	aːksiːdʒən
तुमीच	ʈʊmiːtʃ
प्रौद्योगिकी	pɾɔːdjoːɡɪkiː
सकेगा	səkeːɡaː
झकझोर	dʒʰəkədʒʰoːɾ
उनतालीस	ʊnəʈaːliːs
आवांज	aːʋãdʒ
उधेङ	ʊdʰeːŋ
चिंतित	tʃiː̃ʈɪt
कंकाल	kə̃kaːl
थी?	tʰiː
टाईड	ʈaːiːɖ
मिस्तास्सिनी	mɪsʈaːssɪniː
डाल्फिनकहाँ	ɖaːlpʰɪnəkəɦã
गोल्ड	ɡoːlɖ
नकारापेंटागन	nəkaːɾaːpẽːʈaːɡən
शर्मिन्दा	ʃərmɪndaː
हवास	ɦəʋaːs
उपक्रीड़ा	ʊpəkəɾɪːɽaː
जीटीबी	dʒiːʈiːbiː
खैरात	kʰɛːɾaːt
ब्यूटीशियन	bjuːʈiːʃɪjən
ईटिंग	iːʈiː̃ɡ
मोहेंजोदड़ो	moːɦẽːdʒoːdəɽoː
जताई	dʒəʈaːiː
गुवाहाटी	ɡʊʋaːɦaːʈiː
गुवांगजुटो	ɡʊʋãɡədʒʊʈoː
गुसलखाने	ɡʊsələkʰaːneː
गुसांई	ɡʊsãiː
हैरत	ɦɛːɾət